ARS	Arsenal
AVL	Aston Villa
BHA	Brighton and Hove Albion
BOU	Bournemouth
BRE	Brentford
BUR	Burnley
CHE	Chelsea
CRY	Crystal Palace
EVE	Everton
FUL	Fulham
LEE	Leeds United
LIV	Liverpool
MCI	Manchester City
MUN	Manchester United
NEW	Newcastle United
NFO	Nottingham Forest
SUN	Sunderland
TOT	Tottenham Hotspur
WHU	West Ham United
WOL	Wolverhampton Wanderers
